sim_index,c1_actual,c2_actual,i1_expected,i2_expected,c1_to_i1,c1_to_i2,c2_to_i1,c2_to_i2,i1_counted,i2_counted,c1_computed,c2_computed,c1_percent_error,c2_percent_error,max_percent_error
0,500000,500000,500000,500000,349739,150261,150564,349436,500303,499697,500758,499242,0.1516,0.1516,0.1516
1,500000,500000,500000,500000,349711,150289,150134,349866,499845,500155,499613,500387,0.0774,0.0774,0.0774
2,500000,500000,500000,500000,349917,150083,150443,349557,500360,499640,500900,499100,0.18,0.18,0.18
3,500000,500000,500000,500000,350159,149841,150135,349865,500294,499706,500735,499265,0.147,0.147,0.147
4,500000,500000,500000,500000,349944,150056,150727,349273,500671,499329,501678,498322,0.3356,0.3356,0.3356
5,500000,500000,500000,500000,350726,149274,150111,349889,500837,499163,502093,497907,0.4186,0.4186,0.4186
6,500000,500000,500000,500000,349678,150322,149819,350181,499497,500503,498743,501257,0.2514,0.2514,0.2514
7,500000,500000,500000,500000,350238,149762,149523,350477,499761,500239,499403,500597,0.1194,0.1194,0.1194
8,500000,500000,500000,500000,349763,150237,149383,350617,499146,500854,497865,502135,0.427,0.427,0.427
9,500000,500000,500000,500000,350177,149823,149798,350202,499975,500025,499938,500062,0.0124,0.0124,0.0124
10,500000,500000,500000,500000,350422,149578,150083,349917,500505,499495,501263,498737,0.2526,0.2526,0.2526
11,500000,500000,500000,500000,350371,149629,149934,350066,500305,499695,500763,499237,0.1526,0.1526,0.1526
12,500000,500000,500000,500000,350191,149809,149782,350218,499973,500027,499933,500067,0.0134,0.0134,0.0134
13,500000,500000,500000,500000,349922,150078,150230,349770,500152,499848,500380,499620,0.076,0.076,0.076
14,500000,500000,500000,500000,350225,149775,149945,350055,500170,499830,500425,499575,0.085,0.085,0.085
15,500000,500000,500000,500000,350245,149755,150390,349610,500635,499365,501588,498412,0.3176,0.3176,0.3176
16,500000,500000,500000,500000,349947,150053,149970,350030,499917,500083,499793,500207,0.0414,0.0414,0.0414
17,500000,500000,500000,500000,350341,149659,149736,350264,500077,499923,500193,499807,0.0386,0.0386,0.0386
18,500000,500000,500000,500000,349736,150264,149120,350880,498856,501144,497140,502860,0.572,0.572,0.572
19,500000,500000,500000,500000,349606,150394,149865,350135,499471,500529,498678,501322,0.2644,0.2644,0.2644
20,500000,500000,500000,500000,350208,149792,149967,350033,500175,499825,500438,499562,0.0876,0.0876,0.0876
21,500000,500000,500000,500000,349724,150276,150113,349887,499837,500163,499593,500407,0.0814,0.0814,0.0814
22,500000,500000,500000,500000,350547,149453,149792,350208,500339,499661,500848,499152,0.1696,0.1696,0.1696
23,500000,500000,500000,500000,350676,149324,149430,350570,500106,499894,500265,499735,0.053,0.053,0.053
24,500000,500000,500000,500000,350880,149120,149765,350235,500645,499355,501613,498387,0.3226,0.3226,0.3226
25,500000,500000,500000,500000,349959,150041,150179,349821,500138,499862,500345,499655,0.069,0.069,0.069
26,500000,500000,500000,500000,349947,150053,150289,349711,500236,499764,500590,499410,0.118,0.118,0.118
27,500000,500000,500000,500000,350055,149945,149849,350151,499904,500096,499760,500240,0.048,0.048,0.048
28,500000,500000,500000,500000,349717,150283,150207,349793,499924,500076,499810,500190,0.038,0.038,0.038
29,500000,500000,500000,500000,350553,149447,150449,349551,501002,498998,502505,497495,0.501,0.501,0.501
30,500000,500000,500000,500000,349906,150094,150036,349964,499942,500058,499855,500145,0.029,0.029,0.029
31,500000,500000,500000,500000,350188,149812,150113,349887,500301,499699,500753,499247,0.1506,0.1506,0.1506
32,500000,500000,500000,500000,350142,149858,149691,350309,499833,500167,499583,500417,0.0834,0.0834,0.0834
33,500000,500000,500000,500000,349989,150011,149799,350201,499788,500212,499470,500530,0.106,0.106,0.106
34,500000,500000,500000,500000,350347,149653,149512,350488,499859,500141,499648,500352,0.0704,0.0704,0.0704
35,500000,500000,500000,500000,349500,150500,149470,350530,498970,501030,497425,502575,0.515,0.515,0.515
36,500000,500000,500000,500000,350027,149973,149785,350215,499812,500188,499530,500470,0.094,0.094,0.094
37,500000,500000,500000,500000,350003,149997,150277,349723,500280,499720,500700,499300,0.14,0.14,0.14
38,500000,500000,500000,500000,349982,150018,150036,349964,500018,499982,500045,499955,0.009,0.009,0.009
39,500000,500000,500000,500000,349901,150099,149883,350117,499784,500216,499460,500540,0.108,0.108,0.108
40,500000,500000,500000,500000,349983,150017,149943,350057,499926,500074,499815,500185,0.037,0.037,0.037
41,500000,500000,500000,500000,349619,150381,150104,349896,499723,500277,499308,500692,0.1384,0.1384,0.1384
42,500000,500000,500000,500000,350247,149753,149879,350121,500126,499874,500315,499685,0.063,0.063,0.063
43,500000,500000,500000,500000,349751,150249,150432,349568,500183,499817,500458,499542,0.0916,0.0916,0.0916
44,500000,500000,500000,500000,349961,150039,149820,350180,499781,500219,499453,500547,0.1094,0.1094,0.1094
45,500000,500000,500000,500000,349453,150547,150339,349661,499792,500208,499480,500520,0.104,0.104,0.104
46,500000,500000,500000,500000,349623,150377,150490,349510,500113,499887,500283,499717,0.0566,0.0566,0.0566
47,500000,500000,500000,500000,349934,150066,149690,350310,499624,500376,499060,500940,0.188,0.188,0.188
48,500000,500000,500000,500000,350316,149684,149677,350323,499993,500007,499983,500017,0.0034,0.0034,0.0034
49,500000,500000,500000,500000,349539,150461,150081,349919,499620,500380,499050,500950,0.19,0.19,0.19
50,500000,500000,500000,500000,350388,149612,150256,349744,500644,499356,501610,498390,0.322,0.322,0.322
51,500000,500000,500000,500000,350229,149771,150072,349928,500301,499699,500753,499247,0.1506,0.1506,0.1506
52,500000,500000,500000,500000,349978,150022,150345,349655,500323,499677,500808,499192,0.1616,0.1616,0.1616
53,500000,500000,500000,500000,349693,150307,149565,350435,499258,500742,498145,501855,0.371,0.371,0.371
54,500000,500000,500000,500000,349995,150005,149992,350008,499987,500013,499968,500032,0.0064,0.0064,0.0064
55,500000,500000,500000,500000,350229,149771,150177,349823,500406,499594,501015,498985,0.203,0.203,0.203
56,500000,500000,500000,500000,349738,150262,149996,350004,499734,500266,499335,500665,0.133,0.133,0.133
57,500000,500000,500000,500000,350472,149528,150129,349871,500601,499399,501503,498497,0.3006,0.3006,0.3006
58,500000,500000,500000,500000,350134,149866,150303,349697,500437,499563,501093,498907,0.2186,0.2186,0.2186
59,500000,500000,500000,500000,350036,149964,149443,350557,499479,500521,498698,501302,0.2604,0.2604,0.2604
60,500000,500000,500000,500000,349867,150133,150483,349517,500350,499650,500875,499125,0.175,0.175,0.175
61,500000,500000,500000,500000,349774,150226,149815,350185,499589,500411,498973,501027,0.2054,0.2054,0.2054
62,500000,500000,500000,500000,349335,150665,150011,349989,499346,500654,498365,501635,0.327,0.327,0.327
63,500000,500000,500000,500000,349460,150540,150281,349719,499741,500259,499353,500647,0.1294,0.1294,0.1294
64,500000,500000,500000,500000,349601,150399,150085,349915,499686,500314,499215,500785,0.157,0.157,0.157
65,500000,500000,500000,500000,350223,149777,150530,349470,500753,499247,501883,498117,0.3766,0.3766,0.3766
66,500000,500000,500000,500000,350191,149809,150080,349920,500271,499729,500678,499322,0.1356,0.1356,0.1356
67,500000,500000,500000,500000,350160,149840,149578,350422,499738,500262,499345,500655,0.131,0.131,0.131
68,500000,500000,500000,500000,350133,149867,150668,349332,500801,499199,502003,497997,0.4006,0.4006,0.4006
69,500000,500000,500000,500000,349159,150841,150239,349761,499398,500602,498495,501505,0.301,0.301,0.301
70,500000,500000,500000,500000,349211,150789,149683,350317,498894,501106,497235,502765,0.553,0.553,0.553
71,500000,500000,500000,500000,350274,149726,150553,349447,500827,499173,502068,497932,0.4136,0.4136,0.4136
72,500000,500000,500000,500000,350443,149557,150128,349872,500571,499429,501428,498572,0.2856,0.2856,0.2856
73,500000,500000,500000,500000,350307,149693,150120,349880,500427,499573,501068,498932,0.2136,0.2136,0.2136
74,500000,500000,500000,500000,349728,150272,149925,350075,499653,500347,499133,500867,0.1734,0.1734,0.1734
75,500000,500000,500000,500000,349979,150021,150288,349712,500267,499733,500668,499332,0.1336,0.1336,0.1336
76,500000,500000,500000,500000,349775,150225,150452,349548,500227,499773,500568,499432,0.1136,0.1136,0.1136
77,500000,500000,500000,500000,349966,150034,150413,349587,500379,499621,500948,499052,0.1896,0.1896,0.1896
78,500000,500000,500000,500000,349859,150141,150222,349778,500081,499919,500203,499797,0.0406,0.0406,0.0406
79,500000,500000,500000,500000,350067,149933,150093,349907,500160,499840,500400,499600,0.08,0.08,0.08
80,500000,500000,500000,500000,350231,149769,150329,349671,500560,499440,501400,498600,0.28,0.28,0.28
81,500000,500000,500000,500000,350464,149536,150099,349901,500563,499437,501408,498592,0.2816,0.2816,0.2816
82,500000,500000,500000,500000,350320,149680,149941,350059,500261,499739,500653,499347,0.1306,0.1306,0.1306
83,500000,500000,500000,500000,350248,149752,150260,349740,500508,499492,501270,498730,0.254,0.254,0.254
84,500000,500000,500000,500000,349804,150196,150713,349287,500517,499483,501293,498707,0.2586,0.2586,0.2586
85,500000,500000,500000,500000,349772,150228,149421,350579,499193,500807,497983,502017,0.4034,0.4034,0.4034
86,500000,500000,500000,500000,350652,149348,149779,350221,500431,499569,501078,498922,0.2156,0.2156,0.2156
87,500000,500000,500000,500000,350473,149527,149866,350134,500339,499661,500848,499152,0.1696,0.1696,0.1696
88,500000,500000,500000,500000,350576,149424,150074,349926,500650,499350,501625,498375,0.325,0.325,0.325
89,500000,500000,500000,500000,349553,150447,149427,350573,498980,501020,497450,502550,0.51,0.51,0.51
90,500000,500000,500000,500000,350331,149669,149755,350245,500086,499914,500215,499785,0.043,0.043,0.043
91,500000,500000,500000,500000,349820,150180,150254,349746,500074,499926,500185,499815,0.037,0.037,0.037
92,500000,500000,500000,500000,349884,150116,149602,350398,499486,500514,498715,501285,0.257,0.257,0.257
93,500000,500000,500000,500000,350463,149537,149516,350484,499979,500021,499948,500052,0.0104,0.0104,0.0104
94,500000,500000,500000,500000,350107,149893,150283,349717,500390,499610,500975,499025,0.195,0.195,0.195
95,500000,500000,500000,500000,349775,150225,150302,349698,500077,499923,500193,499807,0.0386,0.0386,0.0386
96,500000,500000,500000,500000,349750,150250,149883,350117,499633,500367,499083,500917,0.1834,0.1834,0.1834
97,500000,500000,500000,500000,350071,149929,150291,349709,500362,499638,500905,499095,0.181,0.181,0.181
98,500000,500000,500000,500000,349745,150255,149982,350018,499727,500273,499318,500682,0.1364,0.1364,0.1364
99,500000,500000,500000,500000,350369,149631,150217,349783,500586,499414,501465,498535,0.293,0.293,0.293
